11111111111
10P0C000001
10000000001
1000000E001
11111111111