11111111111
10P00000E01
10000011111
1000001C001
11111111111