11111111111111111111111
1CECCCCCCCCCCCCCCCCCCC1
1CDDDCCCCCCCCCCCCCCCCC1
1CDPDCCCCCCCCCCCCCCCCC1
1CDDDCCCCCCCCCCCCCCCCC1
11111111111111111111111