11111111111111111111111
10DCDDDDDDDDDDDDDDDDDD1
11DCCCCCCCCCCCCCCCDDD11
1DDC000DDDCDDDDDDCD11D1
1DDCDD00000DDDDDCCDD001
1DDEDD1DDDDDDD11DCD0DD1
1DDDDDDDDDDDD10DCPDDD11
11111111111111111111111