11111111111111111111111
1D1DDDDD1DD000DDDCEDDD1
1D11DDDD11D011D0DCCCCD1
1DD11DDDDD1PCDD001DDCD1
1D1DDDDDDDDCD11DDD1DCD1
100000DDDDDCCDDDDDDCCD1
1DDDDDDDDDDDCCCCCCCCD11
1DDDDDDDDDD1DDDDDDDDD11
11111111111111111111111